
Level 43
     ####
     # @#
     #  #
###### .#
#   $  .#
#  $$# .#
#    ####
###  #
  ####

#####
#   #
#@$.#
#####


Level 3
  ####
###  ####
#     $ #
# #  #$ #
# . .#@ #
#########

Level 4
########
#      #
# .**$@#
#      #
#####  #
    ####