


#####
#   #
#@$.#
#####

Level 1
####
# .#
#  ###
#*@  #
#  $ #
#  ###
####