


#####
#   #
#@$.#
#####


Level 3
  ####
###  ####
#     $ #
# #  #$ #
# . .#@ #
#########

Level 4
########
#      #
# .**$@#
#      #
#####  #
    ####