

#####
#.$ #
#@  #
#####

####
# .#
#  ###
#*@  #
#  $ #
#  ###
####
