

#####
#   #
#@$.#
#####

Level 43
     ####
     # @#
     #  #
###### .#
#   $  .#
#  $$# .#
#    ####
###  #
  ####

Level 3
  ####
###  ####
#     $ #
# #  #$ #
# . .#@ #
#########

Level 4
########
#      #
# .**$@#
#      #
#####  #
    ####


Level 14
#######
#     #
# # # #
#. $*@#
#   ###
#####

Level 15
     ###
######@##
#    .* #
#   #   #
#####$# #
    #   #
    #####

Level 16
 ####
 #  ####
 #     ##
## ##   #
#. .# @$##
#   # $$ #
#  .#    #
##########